NO ./img/play.xpm
SO ./img/play.xpm
WE ./img/play.xpm
EA ./img/title.xpm

F 0,0,0
C 0,0,0

1111111111111111111111111
1000000000110000000000001
1011000000000000000000001
100100000000N000000000001
1111111111111111111111111
