SO ./img/texture_s.xpm
WE ./img/texture_w.xpm
EA ./img/texture_e.xpm
NO ./img/texture_n.xpm

F 0,0,255
C 0,0,25

			
1111111111111111111111
100000DDD0000100000001
11000D0D00010001111111
10000DDD00000001
1000000110000001
1000000000000001
1001000000N00001
1001000000001001
1111111111111111