NO ./img/play.xpm
SO ./img/play.xpm
WE ./img/play.xpm
EA ./img/title.xpm

F 0,0,40
C 0,0,25

11111111111111111
10W00000100000001
11000000D00010001
11000000100000001
11000000110000001
11000000001100001
11001000000000001
11001000000001001
11111111111111111