NO ./img/play.xpm
SO ./img/play.xpm
WE ./img/play.xpm
EA ./img/title.xpm

F 34,139,34
C 135,206,235

11111111111111111
10E00000100000001
11000000D00010001
11000000100000001
11000000010000001
11000000001100001
11001000000000001
11001000000001001
11111111111111111