111111111111111111111111111111
1C0001000000000000000000100001
100001000000000000000000100001
1000C0000000000000000C001C0001
1111110000000P0000000000111011
100000000000010010000000001C01
100000010011110011110010001001
1111100100000000CC000010000001
100000011111110011111110000001
1000C0000000000000000000001001
100000000011111111110000001001
100000000000000000000000001001
1010000000000100100000000C0001
1E1C0000000001CC10000000000001
111111111111111111111111111111
