NO ./img/play.xpm
SO ./img/play.xpm
WE ./img/play.xpm
EA ./img/title.xpm

F 34,139,34
C 135,206,235

11111
11N11
11111