NO ./img/texture_n.xpm
SO ./img/texture_s.xpm
WE ./img/texture_w.xpm
EA ./img/texture_e.xpm

F 0,0,255
C 0,0,25

fff

     11111111111111111
111111DDD0000100000001
110000D0D0001000111111
110000DDD000000W1
11000000110000001
11000000001100001
11001000000000001
11001000000001001
11111111111111111
