SO ./img/texture_s.xpm
WE ./img/texture_w.xpm
EA ./img/texture_e.xpm
NO ./img/texture_n.xpm

F 0,0,40
C 0,0,25

			
1111111111111111111111
100000DDD0000100000001
11000D0D00010001111111
10000DDD00000001
1000000110N00001
1000000001010001
1001000010101001
1001000001010001
1111111111111111