SO ./img/texture_s.xpm
WE ./img/texture_w.xpm
EA ./img/texture_e.xpm
NO ./img/texture_n.xpm

F 0,80,0
C 0,0,25

			
1111111111111111111111
1001000111111000000001
1111000111001001111111
100000000100000100001
100110000001000D00001
1E0000000100000100001
111100011101100111111111
100100011000000D00000001
111111111111111111111111
