SO ./img/texture_s.xpm
WE ./img/texture_w.xpm
EA ./img/texture_e.xpm
NO ./img/texture_n.xpm

F 0,0,40
C 0,0,25

			
1111111111111111111111
1001000111111000000001
1111000111000001111111
100000000000000100001
100100000000000D00001
100000000000000100001
111100011100000111111111
100100011000000D00000W01
111111111111111111111111
