SO ./img/texture_s.xpm
WE ./img/texture_w.xpm
EA ./img/texture_e.xpm
NO ./img/texture_n.xpm

F 0,0,25512
C 0,0,25

			
1111111111111111111111
1001000111111000000001
1111000010001001111111
1000000000000001
1001000110N00011
1000000110000001
111100011000101111111111
100100011000100000000001
111111111111111111111111
